空空空空空空空空空空空空空空空
空空空空空空空空空空空空空空空
空空空空空空空空空空空空空空空
空空砖空空空空空空空钢空空空空
空空空砖空空空水空空钢空钢空空
空空空砖空空空空空空钢空空钢空
空空空砖空空空空空空空空空空空
空空空砖空空空空砖空空草空空空
空空空空空空空空空空空草空空空
空空空空空空空空空空空草空空空
空空空空空空空空空空空空空空空
空空空空空空空空空空空空空空空
空空空空空空空空空空空空空空空
空空空空空空空空空空空空空空空
空空空空空空空空空空空空空空空
